8 8

########
#.#....#
#......#
###.#..#
#...#..#
#.##.#.#
#....#.#
########

################