16 16

################
#...##...##....#
#......#.##.##.#
#...####.......#
##.##.##.####.##
#..##.##..###..#
#.##...##..###.#
#....#.........#
##.###.##.####.#
##..#####.##...#
###..#.##.##.###
#...##...###...#
#.##..##.###...#
#......#.......#
###.##..#.##...#
################