8 8

########
#......#
#......#
#......#
#......#
#......#
#......#
########